NO ./textures/authors/alaktari.xpm
WE ./textures/doom/figure1.xpm
SO ./textures/authors/midbella.xpm
EA ./textures/doom/figure2.xpm
F 255,255,255
C 0,0,0

1111111111111111111111111
1000000000000000000100001
1001000000000000000000001
1000000000100000000000001
1000000000000000100100001
1000000000000000000000001
1000000000000000000100001
1N00000010000000000001001
1111111111111111111111111