SO ./textures/doom/wall1.xpm
NO ./textures/doom/wall3.xpm
WE ./textures/doom/figure1.xpm
EA ./textures/doom/figure2.xpm
DOOR ./textures/doors/door2.xpm
C 200,40,200
F 63,99,13

                                                     1111111111111111111111111111111111
                                                    10000000000000D000000000000000000001
                                                   10011111111111110000000000000000000001
                                                   1001           11000000000000000000011
                                                   1001           11100000000000000000111
                                                   1001           11110000000000000001111
                                                   1001           11111000000000000011111
                                                   1001           11111100000000000111111
                                                 111001           11111110000000001111111
                                                1000001           11111111000000011111111
                                               10011001           11111111100000111111111
                                              1001 1001           11111111110001111111111
1111111111111111111111111111111111111111111111001  1001           11111111111D11111111111
1N0000110000000000011000000000000000000000000001   1001           10000000000000000000001
10000001100000000011000000000000000000000000001    1001           10000000000000000000001
10000000110000000110000000000000000000000000001    1001           10000000000000000000001
10000000011000001100000000000000000000000000001    1001           10000000000000000000001
10000000001100011000000000000000000000000000001    1001           10000000000000000000001
10000000000110110000000000000000000000000000001    1001           10000000000000000000001
1000000000011D110000000000000000000000000000001    1001           10000000000000000000001
100000000000000D0000000000000000000000000000001    1001           10000000000000000000001
1000000000011D11000000000000000000000000000000111111D111111111111110000000000000000000001
1000000000110001100000000000000000000000000000D00000000D000000000000000000000000000000001
1000000001100000110000000000000000000000000000111111D111111111111110000000000000000000001
10000000110000000110000000000000000000000000001    1001           10000000000000000000001
10000001100000000011000000000000000000000000001    1001           10000000000000000000001
10000011000000000001100000000000000000000000001    1001           10000000000000000000001
1000011000000000000010000000000000000000000001     1001            100000000000000000001
111111111111111111111001111111111111111111111      1001             1111111111111111111
                    1001                           1001
                    1001                           1001
                    1001                           1001
                    1001                           1001
                    1001                           1001
                    1001                           1001
                    10011111111111111111111111111111001
                    10000000000010000000000000000000001
                     10000000000D000000000000000000001
                      1111111111111111111111111111111