NO ./textures/doom/figure1.xpm
SO ./textures/doom/figure2.xpm
WE ./textures/doom/wall1.xpm
EA ./textures/doom/wall4.xpm
DOOR ./textures/doors/door2.xpm
C 133,200,86
F 86,200,133

11111111111111111111111111111111111111111111111111111111111111111111111111111
1N001001110101011011000100111010101101100010011101010110110001001110101011011
1010001111111111101101000111111011110110100011111101111011D100011111101111011
100010000000D00000000001000000D0000000000010000000000000000101000000000000011
10101101100111010011010110110010101001101011011001010100110101101100101010011
10000110100101110001000011010010111000100001101001011100010000110100101110001
10011000010000001001001100001000000100100110000100000010010011000010000001001
10100100000001100001010010000000110000101001000000011000010100100000001100001
101011D1100010010101010110110001001010101011011000100101010101101100010010101
1100000101010100111110000010101010011111000001010101001111100000101D101001111
11110101110111001001111010111011100100111101011101110010011110101110111001001
10010000111011D11011001000011101101101100100001110110110110010000111011011011
100000101001100110010000010100110011001000001D1001100110010000010100110011001
10101010100011100101010101010001110010101010101000111001010101010100011100101
10110000001011001111011000000101100111101100000010110011110110000001011001111
10011110011100001111001111001110000111100111100111000011110011110011100001111
10000001001110100001000000100111010000100000010011101000010000001001110100001
11111100001111010011111110000111101001111111000011110100111111100001111010011
10001101101100101001000110110110010100100011011011001010010001101101100101001
11111111111111111111111111111111111111111111111111111111111111111111111111111
