NO ./textures/colors/red.xpm
SO ./textures/colors/blue.xpm
WE ./textures/colors/green.xpm
EA ./textures/colors/purple.xpm
DOOR ./textures/door.xpm
F 100,100,250
C 0,0,0

1111111
1000001
1001D11
100DN01
1111111