NO ./textures/brickwall1.xpm
SO ./textures/brickwall2.xpm
WE ./textures/brickwall3.xpm
EA ./textures/brickwall4.xpm
DOOR ./textures/door.xpm
F 98,105,109
C 80,130,155


111111111111111111111111111
  11110000000000000000000001   
  1000000000000001000000001
 1000000000000000000000001
1000000010000111100000001
 10000000000001D1110000001
 1000000000000000000000001
  1100000000000000000000001
  1000000000000000000000001
 1000000000000000000000001
10000000000000000000000001
 11000001000000000001100001
  1000000100000000000000001
   1000000000000000000000001
  1000000000000000000000001
 1000000000000000000000001
 1000000000000000000000001
 1000000000000000000000001
  1000000000000000000000001
   1000000000000000000000001
  1000000000000000000000001
 10000000000N0000000000001
  1111111111111111111111111         
