NO ./textures/wood.xpm
SO ./textures/wood.xpm
WE ./textures/grass.xpm
EA ./textures/brick.xpm
F 15,6,0
C 100,60,1

11111111111111111111111111
11100000000000000000000001
10000000000000000000000011
1000000000000000000000001
10100000000N0000000000001
1000000000000000000000001
1000000000000000000000001
1000000000000000000000001
1111011110000000000000001
1000000010000000000000001
1000000010000000000000001
1000000000000000000000001
1000000010000000000000001
1000000010000000000000001
1111011110000000000000001
1000000000000000000000001
1000000000000000000000001
1000000000000000000000001
1000000000000000000000001
1000000000000000000000001
1000000000000000000000001
1000000000000000000000001
1000000000000000000000001
1000000000000000000000001
1000000000000000000000001
1000000000000000000000001
1000000000000000000000001
1000000000000000000000001
1000000000000000001000101
1100000000011100000000001
1111111111111111111111111
