NO ./textures/colors/blue.xpm
SO ./textures/colors/red.xpm
WE ./textures/colors/green.xpm
EA ./textures/colors/purple.xpm

F 100,100,250
C 0,0,0

1111111
101D111
10D0ED1
101D111
1000001
1111111