NO ./textures/colors/blue.xpm
SO ./textures/colors/red.xpm
WE ./textures/colors/green.xpm
EA ./textures/colors/purple.xpm
DOOR ./textures/door.xpm
F 100,100,250
C 0,0,0

1111111111111111111111111111111
1000000000000000000000000000001
1000000000000000000000000000001
1000000000000000000000000000001
111111111111111D111111111111111
1000000000000000000000000000001
1000000000000000000000000000001
1000000000000000000000000000001
1000000001D10000000000000000001
1000000000000000000000000000001
1000000000000000000000000000001
1000000000000000000000000000001
1000000000000000000000000000001
1000000000000000000000000000001
111111111111111D111111111111111
1000001000000000000000000000001
1000001000000000000000000000001
1000001000000000000000000000001
1000001000000000000000000000001
100000D000000000000000000000001
1000001000000000000000000000001
1000001000000000000000000000001
1000001000000000000000000000001
1000001000000000000000000000001
111111111111111D111111111111111
1000000000000000000000000000001
1000000000000000000000000000001
1000000000000000000000000000001
1000000000000000000000000000001
1000000000000000000000000000001
111111111111111D111111111111111
1000000000000000000000000000001
1000000000000000000000000000001
1000000000000000000000000000001
1000000000000000000000000000001
1000000000000000000000000000001
1000000000000S00000000000000001
1000000000000000000000000000001
1111111111111111111111111111111
