NO ./textures/bleu.xpm
SO ./textures/red.xpm
WE ./textures/green.xpm
EA ./textures/perpule.xpm
DOOR ./textures/door.xpm
F 100,100,250
C 0,0,0

1111111111111111111111111111111
1000000000000000000000000000001
1000000000000000000000000000001
1000000000000000000000000000001
111111111111111H111111111111111
1000000000000000000000000000001
1000000000000000000000000000001
1000000000000000000000000000001
1000000001H10000000000000000001
1000000000000000000000000000001
1000000000000000000000000000001
1000000000000000000000000000001
1000000000000000000000000000001
1000000000000000000000000000001
111111111111111H111111111111111
1000001000000000000000000000001
1000001000000000000000000000001
1000001000000000000000000000001
1000001000000000000000000000001
100000V000000000000000000000001
1000001000000000000000000000001
1000001000000000000000000000001
1000001000000000000000000000001
1000001000000000000000000000001
111111111111111H111111111111111
1000000000000000000000000000001
1000000000000000000000000000001
1000000000000000000000000000001
1000000000000000000000000000001
1000000000000000000000000000001
111111111111111H111111111111111
1000000000000000000000000000001
1000000000000000000000000000001
1000000000000000000000000000001
1000000000000000000000000000001
1000000000000000000000000000001
1000000000000S00000000000000001
1000000000000000000000000000001
1111111111111111111111111111111
