NO ./textures/bleu.xpm
SO ./textures/red.xpm
WE ./textures/green.xpm
EA ./textures/perpule.xpm
F 100,100,250
C 0,0,0



                1
               101
              10001
             1000001
            100000001
           10000000001
          1000000000001
         100000000000001
        10000000000000001
       1000000000000000001
      100000000000000000001
     10000000000000000000001
     10000000000000000000001
     10000000000000000000001
     10000000000N00000000001
     10000000000000000000001
     10000000000000000000001
      100000000000000000001
       1000000000000000001
        10000000000000001
         100000000000001
          1000000000001
           10000000001
            100000001
             1000001
              10001
               101
                1
