NO ./textures/bleu.xpm
SO ./textures/red.xpm
WE ./textures/green.xpm
EA ./textures/perpule.xpm

F 15,6,0
C 100,60,15

11111111111111111111111111
111000000000000000000000001
10000000000000000000000011
1000000000000000000000001
10100000000S0000000000001
1000000000000000000000001
1000000000000000001000101
1100000000011100000000001
1111111111111111111111111
