NO ./textures/colors/blue.xpm
SO ./textures/colors/red.xpm
WE ./textures/colors/green.xpm
EA ./textures/colors/purple.xpm
DOOR ./textures/door.xpm
F 98,105,109
C 80,130,200


1111111111111111111111111
1001000010000000000000111
1001000010000001000000001
10011D1110000000000000001
10010000D0000000000000001
100D000010001000000000001
10011D1110010000000000001
10000000000D0000000000001
1000000000010000000000001
10000000000000000000000N1
1111111111111111111111111

