NO ./textures/bleu.xpm
SO ./textures/red.xpm
WE ./textures/green.xpm
EA ./textures/perpule.xpm

F 98,105,109
C 80,130,200


1111111111111111111111
100N00000000000000000011
1000000000000001000000001
1000000000000000000000001
1000000000000000000000001
1000000000001000000000001
1000000000000000000000001
1000000000000000000000001
1000000000000000000000001
1000000000000000000000001
1111111111111111111111111

