NO ./textures/bleu.xpm
SO ./textures/red.xpm
WE ./textures/green.xpm
EA ./textures/perpule.xpm

F 15,6,0
C 100,60,15

                                    11111111111111111111111111111111111111111111111111
                                    10000000000000000000000000000000000000000000000001
11111111111                         10000001111111111111111000000000000000000000000001
10000000001111                      10000000000000000000000000000000000000000000000001
10010001100001111111                10000000000000000111111111000000000000000000000001
10000100001100000001                10000000000000000001111100000000111111111110000001
10011001101111111101      111111111110000000001000000000111000000000000000011100000001
10000000001      101111111100000000000000000001000000000010000000000000000000000000001
11111111111      100000000001111111110000000001111100000000E00000000001110000110000001
                 111111111111       10000000000000000000000000000000000000000000000001
                                    10000000000011100000001100100000000000110001100001
                                    10000000110000000000001110100000000000110000000001
                                    10000111110000000000000000000101000000110000000001
                                    10000000000000000000000000000101000000110001010001
                                    10011111110000000000000011111101111110000000000001
                                    10000000000000000000000000000000000000000000000001
                                    11111111111111111111111111111111111111111111111111
            