NO ./textures/N-texture.xpm
SO ./textures/S-texture.xpm
WE ./textures/W-texture.xpm
EA ./textures/E-texture.xpm

F 0,0,0
C 225,30,0

1111111111111111111111111
1000000000000000000000001
1000000000000000000000001
100S000000000000000000001
1010000000000000000000001
1000000000000000000000001
1000000000000000001000101
1100000000011100000000001
1111111111111111111111111
