NO ./textures/N-texture.xpm
SO ./textures/S-texture.xpm
WE ./textures/W-texture.xpm
EA ./textures/E-texture.xpm

F 0,0,0
C 225,30,0

1111111
1000001
1001101
100E001
1010001
1000001
1111111
