NO ./path_to_the_north_texture
SO ./path_to_the_south_texture
WE ./path_to_the_west_texture
EA ./path_to_the_east_texture
F 220,100,0
C 225,30,0
111111111111111111111111111111111111111111111111111111111111111
100101000001
101001110001
110N01111111
111111111
11111111111
1111111111111111111111111111111111111111111111111111111111
111111111111111111111111111
