NO ./textures/colors/blue.xpm
SO ./textures/colors/red.xpm
WE ./textures/colors/green.xpm
EA ./textures/colors/purple.xpm
DOOR ./textures/door.xpm

F 100,100,250
C 0,0,0

1111111111
10001D1001
1001000101
100D000D01
10010E0101
10001D1001
1111111111