NO ./textures/bleu.xpm
SO ./textures/red.xpm
WE ./textures/green.xpm
EA ./textures/perpule.xpm

F 100,100,250
C 0,0,0

1111111
1000001
1000001
10000E1
1111111