NO ./textures/bleu.xpm
SO ./textures/red.xpm
WE ./textures/green.xpm
EA ./textures/perpule.xpm

F 100,100,250
C 0,0,0

111111111
100000001
100000N01
100000001
100000001
111111111