NO ./textures/colors/blue.xpm
SO ./textures/colors/red.xpm
WE ./textures/colors/green.xpm
EA ./textures/colors/purple.xpm
DOOR ./textures/door.xpm

F 100,100,250
C 0,0,0

1111111111
1001000001
1001000001
10010N0001
1001111001
1000000001
1111111111