NO ./textures/bleu.xpm
SO ./textures/red.xpm
WE ./textures/green.xpm
EA ./textures/perpule.xpm
DOOR ./textures/door.xpm

F 100,100,250
C 0,0,0

1111111111
1000000001
10011D1001
100D0N0001
1001000001
1000000001
1111111111