NO ./textures/bleu.xpm
SO ./textures/red.xpm
WE ./textures/green.xpm
EA ./textures/perpule.xpm

F 100,100,250
C 0,0,0

1111111111
1000000001
1000101001
1000000001
100N000001
1000000001
1111111111