NO ./textures/bleu.xpm

SO ./textures/red.xpm

WE ./textures/green.xpm

EA ./textures/perpule.xpm

DOOR ./textures/door.xpm

F 100,100,250

C 0,0,0

111111111
101010001
1010D0001
1D1010001
100000001
10S000001
111111111