NO ./textures/brickwall1.xpm
SO ./textures/brickwall2.xpm
WE ./textures/brickwall3.xpm
EA ./textures/brickwall4.xpm

F 98,105,109
C 80,130,200

 
111111111111111111111111111
  11110000000000000000000001   
  1000000000000001000000001      
 1000000000000000000000001
1000000000000000000000001
 1000000110000000011000001
 1000000000000000000000001
  1100000000000000000000001
  1000000000000000000000001
 1000000000000000000000001
10000000000000000000000001
 11000001100000000001100001
  1000000000000000000000001
   1000000000000000000000001
  1000000000000000000000001
 1000000000000000000000001
 1000000000000000000000001
 1000000000000000000000001
  1000000000000000000000001
   1000000000000000000000001
  1000000000000000000000001
 10000000000N0000000000001
  1111111111111111111111111         
